33343444
34343434
54535453
65434356
65434356
54535453
34343434
33343444
