11111111
55555555
43434343
34343434
34343434
43434343
55555555
11111111
