32322323
33434333
45433224
23566432
23566432
45433224
33434333
32322323
