33333333
43434343
32321321
45456643
45456643
32321321
43434343
33333333
