43533534
43434465
56344321
44443343
44443343
56344321
43434465
43533534
